########################??####
##############            ####
#######       BB    ##########
#######  #########  ##########
#######  #########  ##########
#######  ####C            ####
#######  ###  ##########  ####
#######  ### §##########  ####
#######  ### 2##########  ####
#######  ###  ##########  B§##
#######  ### C##########   B##
#######  ###  ##########    ##
#######  ###  #            ###
#######   1      #############
#######   3           C      #
#############    #############
#############  A #############
##############  ##############
##############    ############
##############            ####
##############  ########! ####
###                    #######
#######       #######     ####
#########  ##########     ####
#########  ############ABA####
#########  ############ § ####
########  #############331####
?   o       ##################
?  ###########################
##############################
Est :
Sud :
Ouest : niveau8.level
Nord : niveau6.level

A
Pv : 5
Force : 1
Armure : 1

B
Pv : 10
Force : 2
Armure : 3

C
Pv : 20
Force : 5
Armure : 5
