##############################
#                            #
#                            #
#                            #
#                            #
#                            #
#                            #
#                            #
#                            #
#  §3333333333333333333333§  #
#                            #
#   21111112     21111112    #
#  21          21            #
#  21     1222 21      1222  #
#  21      12  21       12   #
#   22222222     22222222    #
#                            #
#  §3333333333333333333333§  #
#                            #
#                            #
#                            #
#                            #
#                            #
#                            #
#                            #
#                            #
#                            #
#                            #
#                            #
##############?###############
Est :
Sud : niveau5.level
Ouest :
Nord :